WWWWWWWWWWWWWWWWWWWWWWWWWWWWWWWWWWWWWWWWWWWWWWWWWWWWWWWWWWWW
WWWWWWWWWWWWWWWWWWWWWWWWWWWWWWWWWWWWWWWWWWWWWWWWWWWWWWWWWWWW
WWJ       D                         B                E   KWW
WW WW WWW WW WW WW WW WW WW WWWW WW WW WW WW WW WW WWW WWWWW
WW     W  WW D               D                  WW  W D   WW
WW WW WWW WW WWWWWWWWWWWWWWWWWWWWWWWWWWWWWWWWWW WW WWWEWW WW
WW WW  W  WW W                           E    W WW  W  WW WW
WW WW WWW WW W WWW W WW WW WWWWWW WW WWBW WWW W WW WWWKWW WW
WW WW  W  WW W     W WW WW W WW W WW WW W     W WW  WB WW WW
WW WW WWW WW W WWW W                    W WWW W WW WWW WW WW
WW WW  W  WW     W W WW WW W WW W WW WW W W     WW  W  WW WW
WW           WWW W W WW WW W WW W WW WW W W WWW           WW
WW WWWWWW WW  BW W W         D          W W WK  WW WWWWWW WW
WW           WWW W W WW WW W WW W WWBWW W W WWW   D       WW
WW WW  W  WW     W W WW WW W WW W WW WW W W     WW  W  WW WW
WW WW WWW WW W WWW W D                  W WWW W WW WWW WW WW
WW WW  W  WW W     W WW WW W WW W WW WW W     W WW  W  WW WW
WWEWW WWW WW W WWW W WW WW WWWWWWBWW WW W WWW W WW WWW WW WW
WW WW  W  WW W                                W WW  W EWW WW
WW WW WWW WWDWWWWWWWWWWWWWWWWWWWWWWWWWWWWWWWWWWDWW WWW WW WW
WW     W  WW                                    WWK W     WW
WWWWW WWW WW WW WW WW WW WW WWWW WW WW WW WW WW WW WWW WWWWW
WWB                      B                               KWW
WWWWWWWWWWWWWWWWWWWWWWWWWWWWWWWWWWWWWWWWWWWWWWWWWWWWWWWWWWWW
WWWWWWWWWWWWWWWWWWWWWWWWWWWWWWWWWWWWWWWWWWWWWWWWWWWWWWWWWWWW
